7 10
|--------|
|PFP.|.--|
|.P.-|@..|
|.PFP..-.|
|..P.....|
|.PPPPP.P|
|--------|